1111111111
1000000011
1000000001
1100000001
1000010001
1100000101
1001110001
10CC10E011
110001PC01
1111111111
