1111111111111111111111111111111111111111
1000000000001010100001000100100000100011
1000001100011001001011011010110010000001
1000000100000111010000101010101001010001
1000000000000010000011110000000000101001
1000000000000100001000000010110000000101
1000000100101000000101000001000101000001
1000100000000011001000010000010000110001
1100010110000000100001101000000000C00011
1111111010101000000000001001010001E01101
100000100010000000010000000C010010010011
1010010000010101010000010100100010001101
110000000000000010010010000110C000001011
1010000010000000000101000100000111000001
1010000010100000001010000100000000001011
10000001000100010000100001C0111001000101
1000001100100010000010001111000000001011
1000111000000000010001C00000000000001101
1000000100000010100100000111000110000001
1100001000100000000111000000100000000001
1101000000000000100000001000101110000001
1100010000011000100100100000000010000011
1011000001000000010000001000100100100101
1001010000000100000110001000100000110101
1001001000100110000000000001011010000001
1000000010000000010100001110010101011001
1010000100110000010000000100000000010011
1101000000000001000100100100000000001001
100000100101001010001P000010000101100001
1100000001000000001000100100010000010101
1101000000000001010010001000010011000011
1010100000001000100011000000001000100001
1001000000000001101000000010000000000011
1011100000000000010001010000100000100101
1000000100000000000000100010010001000001
1010111100111110100000010000001010100001
1101001000001000111010001100100000010101
1010010000110011100010000100000001000101
1000000000000000001101011000100110000001
1111111111111111111111111111111111111111
