1111111111111111111111111
1001001001000000000000101
1001000100100100001000001
1011000000000100000010001
1000000000001010100000011
100000000001010010M001011
1000010000001101100100001
1101100100001000100100001
1001000000000100000000001
110101000100M100100000001
1100000000000100000101001
1010C10000001000000010001
1C011001100000000000000P1
1010010000000000000010101
1M00010010000000101010001
1110010001100000110010001
10000000001C0001000011001
1000000000110000110000001
110001001101000C001000111
10E0100C10000000100001001
1001000000001000000010001
1000010010000001000100101
1000000000000100000000011
1010110000000001001001001
1111111111111111111111111
